 1 0 0 0 0 0 0 0 0 0
 1 0 0 0 0 0 0 0 0 0
-1 0 0 1 1 1 0 0 0 0
 1 0 0 1 1 1 0 0 0 0
 1 0 0 0 0 0 0 0 0 0
 1 0 0 0 0 0 0 0 0 0
 1 0 1 0 1 1 1 1 1 1
 1 0 0 0 1 1 1 1 1 1

 0 3 3 3 3 3 3 3 3 3
 0 3 3 3 3 3 3 3 3 3
 3 3 3 0 0 0 3 3 3 3
 0 3 3 0 0 0 3 3 3 3
 0 3 3 3 3 3 3 3 3 3
 0 3 3 3 3 3 3 3 3 3
 0 3 0 3 0 0 0 0 0 0
 0 3 3 3 0 0 0 0 0 0

 0 4 0 0 0 0 0 0 0 0
 0 4 0 0 0 0 0 0 0 0
 0 6 0 0 0 0 0 0 0 0
 0 4 0 0 0 0 0 0 0 0
 0 4 0 0 0 0 0 0 0 0
 0 4 0 0 0 0 0 0 0 0
 0 4 0 0 0 0 0 0 0 0
 0 5 0 0 0 0 0 0 0 0

 0 7 7 7 7 7 7 7 7 8
 0 0 0 0 0 0 0 0 0 0
 0 0 0 0 0 0 0 0 0 0
 0 0 0 0 0 0 0 0 0 0
 0 0 0 0 0 0 0 0 0 0
 0 0 0 0 0 0 0 0 0 0
 0 0 0 0 0 0 0 0 0 0
 0 0 0 0 0 0 0 0 0 0